1111111111111111
100C000001111111
1000000C11111111



1000000000000001
1000000000000001
1000E00000000P01
1000000000000001
1111111111111111




