1111111111111111
100C000001111111
1000000C00011111
1000C00111111111
10C00000C0011111
1000000000000111
1000000000000111
1000C00000000C11
1111011100C01001
1000000000000001
1000C000000C0001
1000000000000001
1000000000000001
1000E00000000P01
1000000000000001
1111111111111111