11111111111111
100000C00E0001
1000000C000001
100C0000000001
1P000000000001
11111111111111
