11111111111111
10000000C00001
100C00100C1111
1P000001100E01
11111111111111