11111111111111
100001C1000001
1000000C000001
10000000000001
100C0010001111
1P000001100E01
11111111111111
