1111111111111
1000000000001
10000P00C0001
100C000000001
1000001111111
100001000E001
1111111111111
